11111111111111
100000P0000001
10011111110001
100C0000000001
10000000000001
10000000C00001
10000000000001
10000000000001
10000000000001
10000000000001
10000000000001
10000E00000001
10000000000001
11111111111111