11111111
100P0C01
1000E001
11111111