11111111111111111111
10000000000000000001
1000P0CCCCCCCCCC0001
100000000000000C0001
100000000000000C0001
100000CCCCCCCCCC0001
100000E0000000000001
10000000000000000001
10000000000000000001
10000000000000000001
11111111111111111111